000000000000000000000000000000
011111111111111111111111111110
011111111111111111111111111110
011111111111111111111111111110
011111111111111111111111111110
011111111111111111111111111110
011111111111111111111111111110
011111111111111111111111111110
011100000000DD0000000001110000
011111111111111111111111111110
011111111111111111111111111110
0111S111111111I111111111111110
011111111111111111111111111110
011111111111111111110111111110
011111111101111111111111111110
011111101011111011110111111110
011001111111011111101101101110
011111111101111101111111110110
01111P11P110110111110110111010
000000000000000000000000000000
