000000000000000000000000000000
011111111111111111111111111110
01s111111111111111111111111110
011d11111111111111111111111110
01s111111111111111111111111110
011111111111111111111111111110
011111111111111111111111111110
011111111111111111111111111110
00000000DD00000000000000000000
011111111111111111111111111110
011111111111111111111111111110
0111S111111111I111111111111110
011111111111111111111111111110
011111111111111111111111111110
011111111111111111111111111110
011111111111111111111111111110
011111111111111111111111111110
011111111111111111111111111110
01111P11P11P11P111111111111110
000000000000000000000000000000
