00000000000000000000000000000000000000000000000000
0V11111H111111111111111111111111111111111111111110
0111111H111111111111111111111111111111111111111110
0111111H111111111111111111111111111111111111111110
0HHHHHHH111111111111111111111111111111111111111110
01111111111S11111111111111111111111111111111111110
01111111111111111111111111111111111111111111111110
01111111111111111111111111111111111111111111111110
01111111111111111111111111111S11111111111111111110
01111111111111111111111111111111111111111111111110
01111111111111111111111111111111111111111111111110
01111111111111111111111111111111111111111111111110
01111111111111111111S1111111111111S111111111111110
01111111111111111111111111111111111111111111111110
01111111111111111111111111111111111111111111111110
01111111111111111111111111111111111111111111111110
01111111111111111111111111S11111111111111111111110
01111111111111111111111111111111111111111111111110
0111111111S111111111111111111111111111111111111110
01111111111111111111111111111111111111111111111110
01111111111111111111111111111111111111111111111110
01111111111111111111111111111111111111111111000000
01111111111111111111111111111111111111111111011110
01111111111111111111111111111111111111111111010110
01111111111111111111111111111111111111111110010110
0000011111111111111111111111111111111111111H110110
01110000000000000000000000000000000000000000010110
01011111111111111111111111111111111111111111110000
01000000000000000000000000000000000000000000000PP0
01111111111111111111111111111111111111111111111PP0
00000000000000000000000000000000000000000000000000